Club, MP, W, D, L, GF, GA, GD, Pts
O'SULLIVAN'S,9,9,0,0,60,27,33,27
BREAKFAST CLUB,9,8,0,1,69,7,62,24
STRAIGHT FROM THE REC,9,5,0,4,43,36,7,15
AFC RICHMOND,9,4,1,4,32,37,-5,13
SUDAMERICA,9,3,1,5,36,36,0,10
OLD FOLKS HOME,9,3,1,5,27,33,-6,10
ANCESTROS,9,3,1,5,22,36,-14,10
FREE AGENTS UNITED,9,3,0,6,31,39,-8,9
REAL OG'S,9,2,1,6,23,48,-25,7
BEERCELONA,9,1,3,5,22,66,-44,6
