Club, MP, W, D, L, GF, GA, GD, Pts
O'SULLIVAN'S,11,11,0,0,70,33,37,33
BREAKFAST CLUB,11,10,0,1,85,7,78,30
STRAIGHT FROM THE REC,11,7,0,4,61,44,17,21
ANCESTROS,11,6,0,5,37,36,1,18
AFC RICHMOND3,9,4,1,4,34,38,-4,13
AFC RICHMOND2,9,4,1,4,34,39,-5,13
AFC RICHMOND,9,4,1,4,32,37,-5,13
SUDAMERICA,11,3,3,5,44,44,0,12
OLD FOLKS HOME,11,3,1,7,31,43,-12,10
FREE AGENTS UNITED,11,3,0,8,41,55,-14,9
REAL OG'S,11,2,1,8,23,54,-31,7
BEERCELONA,11,1,2,8,26,88,-62,5
